{
  "tiles": [
    [ 0, 0, 0, 0, 0, 0, 0, 0, 0, 0, 0 ],
    [ 0, 0, 0, 0, 0, 2, 0, 0, 0, 0, 0 ],
    [ 0, 0, 0, 0, 3, 2, 4, 0, 0, 0, 0 ],
    [ 0, 0, 0, 2, 4, 5, 3, 0, 0, 0, 0 ],
    [ 0, 0, 2, 5, 4, 3, 4, 0, 0, 0, 0 ],
    [ 0, 3, 2, 0, 4, 2, 5, 0, 0, 0, 0 ],
    [ 0, 0, 0, 0, 3, 4, 2, 0, 0, 0, 0 ],
    [ 0, 0, 0, 2, 2, 3, 4, 5, 0, 0, 0 ],
    [ 0, 4, 3, 5, 2, 1, 3, 2, 4, 3, 0 ]
  ]
}

