{
	"tiles": [
		[ 0, 0, 0, 0, 0, 0, 0, 0, 0, 0, 0 ],
		[ 0, 0, 0, 0, 0, 2, 2, 0, 0, 0, 0 ],
		[ 0, 0, 0, 0, 2, 3, 2, 1, 0, 0, 0 ],
		[ 0, 0, 0, 2, 3, 0, 3, 2, 2, 0, 0 ],
		[ 0, 0, 2, 3, 0, 0, 3, 2, 3, 5, 0 ],
		[ 0, 0, 0, 0, 0, 2, 3, 2, 3, 0, 0 ],
		[ 0, 0, 0, 0, 2, 3, 2, 0, 0, 0, 0 ],
		[ 0, 0, 0, 2, 3, 5, 3, 2, 0, 0, 0 ],
		[ 0, 2, 3, 2, 3, 2, 3, 4, 3, 2, 0 ]
	]
}